#================================================================================#
x................................................................................v
x................................................................................v
x.........<=====>.............................. .................................v
x..............................<==>............<===>.............<=>.............v
x................................................................................v
x................................................................................v
x..............<=>......................<>..............................<>.......v
x................................................................................v
x.....<=====>.............<==>.......<=>........<=>..............<==>.....<=>....v
x..............<=>......................<>..............................<>.......v
x................................................................................v
