pbbbbbbbbbbbbbbbbbbbbbbbbbbp
r..........................l
r.................gg.......l
r..........................L
r.....,....<=>.............j
r................BBBB......j
r....g...........BggB......j
r....g...........BBBB......j
r....g.....................j
r...........<==>.....<=>...F
r..........................l
r..........................l
