pbbbbbbbbbbbbbbbbbbbbbbbbbbbbbbbbbbbbbbp
r......................................l
rxxxxxxxxxxxxxxxxxxxxxxxxxxxxxxxxxxxxxxl
r......................................L
r......................................j
r......................................j
r..............gg......................j
r............<===>.....................j
r......................................j
r.....<===>........<===>...............F
r......................................l
r......................................l
