pbbbbbbbbbbbbbbbbbbbbbbbp
r.......................l
rxxxxxxxxxxxxxxxxxxxxxxxl
r.......................L
r.......................j
r.......................j
r....g......g......g....j
r....g......g......g....j
r....g......g......g....j
r.......................F
r.......................l
r.......................l
