pbbbbbbbbbbbbbbbbbbbbp
r....................l
rxxxxxxxxxxxxxxxxxxxxl
r....................L
r....................j
r......B......B......j
r.....BgB....BgB.....j
r......B......B......j
r....................j
r....................F
r....................l
r....................l
