pbbbbbbbbbbbbbbbbbbbbbbbbbbp
r..........................l
rxxxxxxxxxxxxxxxxxxxxxxxxxxl
r..........................L
r..........................j
r..........................j
r..........................j
r......gg.....gg.....gg....j
r..........................j
r.....<==>...<==>...<==>...F
r..........................l
r..........................l
